Airship Escape
An Interactive Fiction by Jenny Tran, Kenneth Cox
Release 1 / Serial number 130314 / Inform 7 build 6G60 (I6/v6.32 lib 6/12N) SD

Jail
The light above you is dim. Your jail cell is open. You can leave through the west doorway.

There is an old man sitting on a wooden bench in a jail cell next to you.

>attack old man
Violence isn't the answer to this one.

* * *

Airship Escape
An Interactive Fiction by Jenny Tran, Kenneth Cox
Release 1 / Serial number 130314 / Inform 7 build 6G60 (I6/v6.32 lib 6/12N) SD

Jail
The light above you is dim. Your jail cell is open. You can leave through the west doorway.

There is an old man sitting on a wooden bench in a jail cell next to you.

>w
West Jail
You walk into another part of the jail and see a door from which light emanates. It's probably the way out. Where are the guards?

You can see a Jail Door and a pot (in which is a silver key) here.

>n
Hallway 1F
A hallway stretches out before you. The walls are plain, the lights are dim, and there are rooms all along the hallway. The jail rooms are in the south. A room labeled the "Exit Room" is to the north. You see a plain door leading to the lounge to the east.

You can enter the elevator here.

>s
Darkness
It is pitch dark, and you can't see a thing.

>look
Darkness
It is pitch dark, and you can't see a thing.

* * *

>n
Hallway 1F
A hallway stretches out before you. The walls are plain, the lights are dim, and there are rooms all along the hallway. The jail rooms are in the south. A room labeled the "Exit Room" is to the north. You see a plain door leading to the lounge to the east.

You can enter the elevator here.

>w
You can't go that way.

* * *

>n
Hallway 1F
A hallway stretches out before you. The walls are plain, the lights are dim, and there are rooms all along the hallway. The jail rooms are in the south. A room labeled the "Exit Room" is to the north. You see a plain door leading to the lounge to the east.

You can enter the elevator here.

>enter elevator
Elevator
To operate: Press number.

>2
That's not a verb I recognise.

>press 2
You press button 2. The elevator whirs into action and moves to the correct level.

>x
What do you want to examine?

* * *

>x room
You can't see any such thing.

>x Elevator
You can't see any such thing.

>exit elevator
East Hallway 2F
You can enter the elevator here.

>w
West Hallway 2F
You can see a Crew Quarters Door here.

>say password
(to yourself)
There is no reply.

* * *

>press 3
You press button 3. The elevator whirs into action and moves to the correct level.

>press 2
You press button 2. The elevator whirs into action and moves to the correct level.

>exit elevator
East Hallway 2F
You can enter the elevator here.

* * *

>w
West Hallway 2F
You can see a Crew Quarters Door here.

>x
(the Crew Quarters Door)
You see nothing special about the Crew Quarters Door.

>x west Hallway
I only understood you as far as wanting to examine west.

>x West Hallway 2F
I only understood you as far as wanting to examine west.

>x The Captains's Door
You can't see any such thing.

>w
(first opening the Captain's Door)
It seems to be locked.

>x Captain's Door
The captain's door has the word "Captain" writen across the top.  There is no door nob or key hole.  On a plaque on the door there is the message 
 "Only those with the password may enter to speak to the captain."

Say the password.

>password
You hear a click inside the door, and it silently swings adjar.
That's not a verb I recognise.

* * *

>exit
deck
The deck is the highest level of the ship.  All around you is space? or sky or something?  There are fishing poles on a rack.

You can enter the elevator here.

There is a fishing rod

>get
What do you want to get?

>list
You can't see any such thing.

>x
What do you want to examine?

>x fishing pole
You see nothing special about Fishing Pole.

* * *

>exit
deck
The deck is the highest level of the ship.  All around you is space? or sky or something?  There are fishing poles on a rack.

You can enter the elevator here.

There is a fishing rod

>get fishing pole
I only understood you as far as wanting to get Fishing Rod.

>x fishing pole
I only understood you as far as wanting to examine Fishing Rod.

>get fishing pole
I only understood you as far as wanting to get Fishing Rod.

>invintory
That's not a verb I recognise.

>inventory
You are carrying nothing.

>combine
What do you want to combine?

>inventory
You are carrying nothing.

>get fishing rod
Taken.

* * *

>exit elevator
East Hallway 2F
You can enter the elevator here.

>enter elevator
Elevator
To operate: Press number.

>exit
East Hallway 2F
You can enter the elevator here.

* * *

>x captain's door
The captain's door has the word "Captain" writen across the top.  There is no door nob or key hole.  On a plaque on the door there is the message 
 "Only those with the password may enter to speak to the captain."

Say the password.

>password
You hear a click inside the door, and it silently swings adjar.

>w
(first opening the Captain's Door)

Captain's Room
You can see a Captiain here.

* * *

>exit
East Hallway 2F
You can enter the elevator here.

>n
Kitchen
You can see a Waffle here.

>get waffle
Taken.

>s
East Hallway 2F
You can enter the elevator here.

>enter elevator
Elevator
To operate: Press number.

* * *

>get fishing rod
Taken.

>combine Waffle and fishing rod
You can't use multiple objects with that verb.

>combine
What do you want to combine?

>combine waffle
What do you want to combine the Waffle with?

>combine waffle with fishing
You combine the Waffle with Fishing Rod and produce a baited fishing rod

>inventory
You are carrying:
  Baited Fishing Rod

* * *

>n
Hallway 1F
A hallway stretches out before you. The walls are plain, the lights are dim, and there are rooms all along the hallway. The jail rooms are in the south. A room labeled the "Exit Room" is to the north. You see a plain door leading to the lounge to the east.

You can enter the elevator here.

>enter
You must supply a noun.

>enter
You must supply a noun.

>enter elevator
Elevator
To operate: Press number.

* * *

>press 3
You press button 3. The elevator whirs into action and moves to the correct level.

>exit
deck
You can enter the elevator here.

>x
(the elevator exterior)
You see nothing special about the elevator exterior.

>x deck
You can't see any such thing.

* * *

>w
West Jail
You walk into another part of the jail and see a door from which light emanates. It's probably the way out. Where are the guards?

You can see a Jail Door and a pot (in which is a silver key) here.

>take key
Taken.

>open door
It seems to be locked.

* * *

>n
(first opening the Jail Door)

Hallway 1F
A hallway stretches out before you. The walls are plain, the lights are dim, and there are rooms all along the hallway. The jail rooms are in the south. A room labeled the "Exit Room" is to the north. You see a plain door leading to the lounge to the east.

You can enter the elevator here.

You can also see an Exit Room Door, a Lounge Door and a Jail Door here.

>e
(first opening the Lounge Door)

Lounge
It's a small area with two doors, one to the north and one to the east. There is a table in the middle of the room, on top of which lies a dirty tablecloth. There are wooden chairs scattered about the room and an uncomfortable-looking couch to the side.

You can see an East Servant Room Door, a North Servant Room Door and a Lounge Door here.

>s
You can't go that way.

>e
(first opening the East Servant Room Door)

South Servant Room
You walk into the room lined with a handful of beds. There is no one around.

You can see an East Servant Room Door and Journal Page 2 here.

>read journal page
Page 2 reads: "We lost many in the battle."

>w
Lounge
It's a small area with two doors, one to the north and one to the east. There is a table in the middle of the room, on top of which lies a dirty tablecloth. There are wooden chairs scattered about the room and an uncomfortable-looking couch to the side.

You can see an East Servant Room Door, a North Servant Room Door and a Lounge Door here.

>n
(first opening the North Servant Room Door)

North Servant Room
You walk into the room lined with a handful of beds. There is no one around.

You can see a North Servant Room Door and Journal Page 1 here.

>take journal page
Taken.

>read page
Page 1 reads: "We won the battle against the wizards!"

>s
Lounge
It's a small area with two doors, one to the north and one to the east. There is a table in the middle of the room, on top of which lies a dirty tablecloth. There are wooden chairs scattered about the room and an uncomfortable-looking couch to the side.

You can see a North Servant Room Door, a Lounge Door and an East Servant Room Door here.

>e
South Servant Room
You walk into the room lined with a handful of beds. There is no one around.

You can see an East Servant Room Door and Journal Page 2 here.

>take page 2
Taken.

>read page 1
Page 1 reads: "We won the battle against the wizards!"

>read page 2
Page 2 reads: "We lost many in the battle."

>read page
Which do you mean, Journal Page 2 or Journal Page 1?

>2
Page 2 reads: "We lost many in the battle."

* * *

Airship Escape
An Interactive Fiction by Jenny Tran, Kenneth Cox
Release 1 / Serial number 130314 / Inform 7 build 6G60 (I6/v6.32 lib 6/12N) SD

Jail
The light above you is dim. Your jail cell is open. You can leave through the west doorway.

There is an old man sitting on a wooden bench in a jail cell next to you.

I beg your pardon?

>w
Darkness
It is pitch dark, and you can't see a thing.

>n
Hallway 1F
A hallway stretches out before you. The walls are plain, the lights are dim, and there are rooms all along the hallway. The jail rooms are in the south. A room labeled the "Exit Room" is to the north. You see a plain door leading to the lounge to the east.

You can enter the elevator here.

>tell elevator hello
You can only do that to something animate.

* * *

Airship Escape
An Interactive Fiction by Jenny Tran, Kenneth Cox
Release 1 / Serial number 130314 / Inform 7 build 6G60 (I6/v6.32 lib 6/12N) SD

Jail
The light above you is dim. Your jail cell is open. You can leave through the west doorway.

There is an old man sitting on a wooden bench in a jail cell next to you.

>combine yourself with yourself
I didn't understand that sentence.

>combine
(the old man and the old man)
cannot combine.

>combine
(the old man and the old man)
cannot combine.

>cast
You cast a spell. It does nothing.

>chant
You cast a spell. It does nothing.

* * *

Airship Escape
An Interactive Fiction by Jenny Tran, Kenneth Cox
Release 1 / Serial number 130314 / Inform 7 build 6G60 (I6/v6.32 lib 6/12N) SD

Jail
The light above you is dim. Your jail cell is open. You can leave through the west doorway.

There is an old man sitting on a wooden bench in a jail cell next to you.

>combine
(the old man and the old man)
cannot combine.