You wake up in a cold place. Your head hurts a little, but it seems like the pain is starting to fade away. You stretch, pick yourself up, and stumble slightly forward. You reach your hand out to grab something to balance yourself, and your hand touches cold, iron bars. That's when you realize it -- you're behind bars! 
 "Ha ha, are you awake now? Welcome to the pirate ship, young man." 
You look up to see an old man sitting on a wooden bench in the jail cell next to you, but it's dim and you can't quite make out the expression on his face. You take a good look around. You're definitely in a jail cell. You regain your balance and straighten your robes. Ah that's right, you're a wizard. A wizard on what is, apparently, a pirate ship. Something tells you that it's time to make an escape.  

Airship Escape
An Interactive Fiction by Jenny Tran, Kenneth Cox
Release 1 / Serial number 130315 / Inform 7 build 6G60 (I6/v6.32 lib 6/12N) SD

Jail
The light above you is dim. Your jail cell is open. You can leave through the west doorway.

There is an old man sitting on a wooden bench in a jail cell next to you.

You see a torch that looks lightable. You recall a fire spell that you learned when you first became a wizard.

>waffle
Kitchen
The kitchen is warm and small, and there is a faint, pleasant aroma of waffles.

You can see a Cook here.

That's not a verb I recognise.

>s
East Hallway 2F
The hallway is decorated with a chocolate-colored wall and light brown polished floorboards that dully reflect the flourescent lights above you. The kitchen is to the north and the bathroom is to the south

You can enter the elevator here.

>enter elevator
Elevator
To operate: Press number.

>press 3
You press button 3. The elevator whirs into action and moves to the correct level.

>exit
deck
The deck is the highest level of the ship.  All around you is space? or sky or something?  There are fishing poles on a rack.

You can enter the elevator here.

There is a fishing rod

>get fishing rod
Taken.

>enter elvator
You can't see any such thing.

>press 2
You cannot control the express panoramic elevator unless you are yourself inside.

>exit
But you aren't in anything at the moment.

>combine
What do you want to combine?

>combine fishing rod with waffle
You combine Fishing Rod with the Waffle and produce a baited fishing rod

>s
You can't go that way.

>enter elevattor
You can't see any such thing.

>enter elevator
Elevator
To operate: Press number.

>press 2
You press button 2. The elevator whirs into action and moves to the correct level.

>exit
East Hallway 2F
You can enter the elevator here.

>s
Bathroom
There is a wooden bench pushed up against the back wall.  This bench has a hole in it.  You can probably guess why

You can't see anything in the dark hole.

>fish
(with Baited Fishing Rod)
You cast the line into the toilet.  You can hear the creature moving through the filth towards the bait.  There a tug on the string and you real it in.  You now have a very stanky fish!

>inbentory
That's not a verb I recognise.

>inventory
You are carrying:
  a Crew Quarters Key
  Baited Fishing Rod

>n
East Hallway 2F
You can enter the elevator here.

>w
West Hallway 2F
You can see a Crew Quarters Door here.

>unlock crew
What do you want to unlock the Crew Quarters Key with?

>unlock crew with key
(the Crew Quarters Key with the Crew Quarters Key)
That doesn't seem to be something you can unlock.

>unlock door with key
(the Crew Quarters Door with the Crew Quarters Key)

>open crew quarters door
You open the Crew Quarters Door.

>location
That's not a verb I recognise.

>x
What do you want to examine?

>x room
You can't see any such thing.

>x West hallway
I only understood you as far as wanting to examine west.

>x west hallway
I only understood you as far as wanting to examine west.

>x hallway
You can't see any such thing.

>get note
You can't see any such thing.

>x door
(the Crew Quarters Door)
You see nothing special about the Crew Quarters Door.

>s
Crew Quarters
You can see a Crew Quarters Door and a note here.

>read note
time whale

>n
West Hallway 2F
You can see a Crew Quarters Door here.

>w
(first opening the Captain's Door)
It seems to be locked.

>x captain
You can't see any such thing.

>x captain's
The captain's door has the word "Captain" writen across the top.  There is no door nob or key hole.  On a plaque on the door there is the message 
 "Only those with the password may enter to speak to the captain."

Say the password.

>time whale
You hear a click inside the door, and it silently swings ajar.

* * *

>s
East Hallway 2F
The hallway is decorated with a chocolate-colored wall and light brown polished floorboards that dully reflect the flourescent lights above you. The kitchen is to the north and the bathroom is to the south

You can enter the elevator here.

>w
West Hallway 2F
You can see a Crew Quarters Door here.

>n
Dining Room
You can see a dining table (on which is a table cloth) here.

>cast fire on the table cloth
You pick up the table cloth first.

lols

>showme
Dining Room - room
    yourself - person
        table cloth
        Waffle
    dining table - supporter

>showme table cloth
table cloth - thing
location: carried by yourself in the Dining Room
singular-named, improper-named; unlit, inedible, portable, handled
printed name: "table cloth"
printed plural name: none
indefinite article: none
description: none
initial appearance: none
printing: "blank"
combinable: false

* * *

>w
West Hallway 2F
You can see a Crew Quarters Door here.

>w
(first opening the Captain's Door)
It seems to be locked.

>x captain's door
The captain's door has the word "Captain" writen across the top.  There is no door nob or key hole.  On a plaque on the door there is the message 
 "Only those with the password may enter to speak to the captain."

Say the password.

>time whale
You hear a click inside the door, and it silently swings ajar.

>n
Dining Room
You can see a dining table (on which is a table cloth) here.

>s
West Hallway 2F
You can see a Crew Quarters Door here.

>w
(first opening the Captain's Door)
It seems to be locked.

* * *

>time whale
You hear a click inside the door, and it silently swings ajar.

>w
(first opening the Captain's Door)
It seems to be locked.

* * *

>time whale
You hear a click inside the door, and it silently swings ajar.

>enter captain's room
I only understood you as far as wanting to enter the Captain's Door.

>enter the captain's room
I only understood you as far as wanting to enter the Captain's Door.

>w
(first opening the Captain's Door)
It seems to be locked.

>pancake
Hallway 1F
A hallway stretches out before you. The walls are plain, the lights are dim, and there are rooms all along the hallway. The jail rooms are in the south. A room labeled the "Exit Room" is to the north. You see a plain door leading to the lounge to the east.

You can enter the elevator here.

You can also see an Exit Room Door, a Lounge Door and a Jail Door here.

That's not a verb I recognise.

>open exit room door
You open the Exit Room Door.

Say the password.

>time whale
You hear a click inside the door, and it silently swings ajar.

>n
Exit Room
You notice a door with a giant, golden lock in the small, empty room. There is no door handle. You cannot open it without the key.

You can see an Exit Room Door here.

* * *

>time whale
You hear a click inside the door, and it silently swings ajar.

>frenchtoast
That's not a verb I recognise.

>x captain's door
The captain's door has the word "Captain" writen across the top.  There is no door nob or key hole.  On a plaque on the door there is the message 
 "Only those with the password may enter to speak to the captain."

Say the password.

>frenchtoast
You hear a click inside the door, and it silently swings ajar.

>pancake
Hallway 1F
A hallway stretches out before you. The walls are plain, the lights are dim, and there are rooms all along the hallway. The jail rooms are in the south. A room labeled the "Exit Room" is to the north. You see a plain door leading to the lounge to the east.

You can enter the elevator here.

You can also see an Exit Room Door, a Lounge Door and a Jail Door here.

That's not a verb I recognise.

* * *

>open exit room door
You open the Exit Room Door.

Say the password.

>time whale
nothing happens

>open exit room door
That's already open.

Say the password.

>frenchtoast
You hear a click inside the door, and it silently swings ajar.

>n
Exit Room
You notice a door with a giant, golden lock in the small, empty room. There is no door handle. You cannot open it without the key.

You can see an Exit Room Door here.

* * *

>time whale
You hear a click inside the door, and it silently swings ajar.

>x captain's door
The captain's door has the word "Captain" writen across the top.  There is no door nob or key hole.  On a plaque on the door there is the message 
 "Only those with the password may enter to speak to the captain."

Say the password.

* * *

>frenchtoast
You hear a click inside the door, and it silently swings ajar.

>w
(first opening the Captain's Door)
It seems to be locked.

* * *

>pancake
Hallway 1F
A hallway stretches out before you. The walls are plain, the lights are dim, and there are rooms all along the hallway. The jail rooms are in the south. A room labeled the "Exit Room" is to the north. You see a plain door leading to the lounge to the east.

You can enter the elevator here.

You can also see an Exit Room Door, a Lounge Door and a Jail Door here.

That's not a verb I recognise.

>n
(first opening the Exit Room Door)

Exit Room
You notice a door with a giant, golden lock in the small, empty room. There is no door handle. You cannot open it without the key.

You can see an Exit Room Door here.

Say the password.

>frenchtoast
You hear a click inside the door, and it silently swings ajar.

>n
You can't go that way.

>s
Hallway 1F
A hallway stretches out before you. The walls are plain, the lights are dim, and there are rooms all along the hallway. The jail rooms are in the south. A room labeled the "Exit Room" is to the north. You see a plain door leading to the lounge to the east.

You can enter the elevator here.

You can also see an Exit Room Door, a Lounge Door and a Jail Door here.

>lock exit room door
(with the Waffle)
First you'll have to close the Exit Room Door.

>close exit room door
You close the Exit Room Door.

>inventory
You are carrying:
  a Waffle

>lock exit room door
(with the Waffle)
That doesn't seem to fit the lock.

* * *

>time whale
You hear a click inside the door, and it silently swings ajar.

>w
(first opening the Captain's Door)

Captain's Room
You can see a Captiain here.

>pancake
Hallway 1F
A hallway stretches out before you. The walls are plain, the lights are dim, and there are rooms all along the hallway. The jail rooms are in the south. A room labeled the "Exit Room" is to the north. You see a plain door leading to the lounge to the east.

You can enter the elevator here.

You can also see an Exit Room Door, a Lounge Door and a Jail Door here.

That's not a verb I recognise.

>x exit room door
You see nothing special about the Exit Room Door.

Please enter your answer now.

>test
You unlocked the door.

>n
(first opening the Exit Room Door)

Exit Room
You notice a door with a giant, golden lock in the small, empty room. There is no door handle. You cannot open it without the key.

You can see an Exit Room Door here.

* * *

>s
East Hallway 2F
The hallway is decorated with a chocolate-colored wall and light brown polished floorboards that dully reflect the flourescent lights above you. The kitchen is to the north and the bathroom is to the south

You can enter the elevator here.

I beg your pardon?

>w
West Hallway 2F
You can see a Crew Quarters Door here.

>x captain's door
The captain's door has the word "Captain" writen across the top.  There is no door nob or key hole.  On a plaque on the door there is the message 
 "Only those with the password may enter to speak to the captain."

Say the password.

* * *

>pancake
Hallway 1F
A hallway stretches out before you. The walls are plain, the lights are dim, and there are rooms all along the hallway. The jail rooms are in the south. A room labeled the "Exit Room" is to the north. You see a plain door leading to the lounge to the east.

You can enter the elevator here.

You can also see an Exit Room Door, a Lounge Door and a Jail Door here.

That's not a verb I recognise.

>open exit room door
It seems to be locked.

Say the password.

>time whale
You hear a click inside the door, and it silently swings ajar.

>n
(first opening the Exit Room Door)
It seems to be locked.

Say the password.

* * *

>s
East Hallway 2F
The hallway is decorated with a chocolate-colored wall and light brown polished floorboards that dully reflect the flourescent lights above you. The kitchen is to the north and the bathroom is to the south

You can enter the elevator here.

>x wall
You can't see any such thing.