Airship Escape
An Interactive Fiction by Jenny Tran, Kenneth Cox
Release 1 / Serial number 130314 / Inform 7 build 6G60 (I6/v6.32 lib 6/12N) SD

Jail
The light above you is dim. Your jail cell is open. You can leave through the west doorway.

There is an old man sitting on a wooden bench in a jail cell next to you.

You see a torch that looks lightable. You recall a fire spell that you learned when you first became a wizard.

>w
Darkness
You walk into another part of the jail. It's pitch black. You're sure you can light it up with fire.

>n
(first opening the Jail Door)
It seems to be locked.

>enter elevator
You can't see any such thing.

>get key
Taken.

>open dooor
You can't see any such thing.

>open door
It seems to be locked.

>unlock door
(with the silver key)
The jail door opens. You can go north into the light.

>n
(first opening the Jail Door)

Hallway 1F
A hallway stretches out before you. The walls are plain, the lights are dim, and there are rooms all along the hallway. The jail rooms are in the south. A room labeled the "Exit Room" is to the north. You see a plain door leading to the lounge to the east.

You can enter the elevator here.

You can also see an Exit Room Door, a Lounge Door and a Jail Door here.

>enter elevator
Elevator
To operate: Press number.

* * *

>exit
East Hallway 2F
You can enter the elevator here.

>n
Kitchen
You can see a Waffle and a Cook here.

>get waffle
The cook will catch you!

* * *

>w
Darkness
You walk into another part of the jail. It's pitch black. You're sure you can light it up with fire.

>get key
Taken.

>n
(first opening the Jail Door)
It seems to be locked.

>unlock
(the silver key with the silver key)
That doesn't seem to be something you can unlock.

>n
(first opening the Jail Door)
It seems to be locked.

>unlock the jail
(with the silver key)
The jail door opens. You can go north into the light.

>n
(first opening the Jail Door)

Hallway 1F
A hallway stretches out before you. The walls are plain, the lights are dim, and there are rooms all along the hallway. The jail rooms are in the south. A room labeled the "Exit Room" is to the north. You see a plain door leading to the lounge to the east.

You can enter the elevator here.

You can also see an Exit Room Door, a Lounge Door and a Jail Door here.

* * *

>exit
East Hallway 2F
You can enter the elevator here.

>s
Bathroom
you look down into the hole in the floor.   The smell alone almost makes you vomit.  You can't see anything, in the dark hole but it almost sounds like something is sloshing around in there.

>x
(the silver key)
You see nothing special about the silver key.

>x monster in the toilet
You see nothing special about the monster in the toilet.

* * *

>w
Darkness
You walk into another part of the jail. It's pitch black. You're sure you can light it up with fire.

>light torch
You can't see any such thing.

>candle
That's not a verb I recognise.

>take candle
You can't see any such thing.

>light candle
You can't see any such thing.

>burn cnadle
You can't see any such thing.

>burn candle
You can't see any such thing.

I beg your pardon?

>torch
That's not a verb I recognise.

>x torhc
You can't see any such thing.

>x torch
You can't see any such thing.

>take torch
You can't see any such thing.

>e
Jail
The light above you is dim. Your jail cell is open. You can leave through the west doorway.

There is an old man sitting on a wooden bench in a jail cell next to you.

You can also see a flaming torch here.

>take torch
Taken.

>w
West Jail
You see that there are no guards around. Now to escape!

You can see a Jail Door and a pot (in which is a silver key) here.

* * *

>w
Darkness
You walk into another part of the jail. It's pitch black. You're sure you can light it up with fire.

>e
Jail
The light above you is dim. Your jail cell is open. You can leave through the west doorway.

There is an old man sitting on a wooden bench in a jail cell next to you.

You can also see a torch here.

>take torch
Taken.

* * *

>e
Jail
The light above you is dim. Your jail cell is open. You can leave through the west doorway.

There is an old man sitting on a wooden bench in a jail cell next to you.

You can also see a torch here.

>light torch
(first taking the torch)

>w
West Jail
You see that there are no guards around. Now to escape!

You can see a Jail Door and a pot (in which is a silver key) here.

>x torch
The torch is lit.

>cast
(the torch)
You hold your hand out in a fist, then open it slowly. Your hand warms up as a dancing ball of flame forms above your palm. With a gentle flick of your wrist, the flames fly out of your hand and to the torch.

>cast torch
You hold your hand out in a fist, then open it slowly. Your hand warms up as a dancing ball of flame forms above your palm. With a gentle flick of your wrist, the flames fly out of your hand and to the torch.

>cast spell on torch
You hold your hand out in a fist, then open it slowly. Your hand warms up as a dancing ball of flame forms above your palm. With a gentle flick of your wrist, the flames fly out of your hand and to the torch.

>cast fire on torch
You hold your hand out in a fist, then open it slowly. Your hand warms up as a dancing ball of flame forms above your palm. With a gentle flick of your wrist, the flames fly out of your hand and to the torch.

>fire on torch
That's not a verb I recognise.

>e
Jail
The light above you is dim. Your jail cell is open. You can leave through the west doorway.

There is an old man sitting on a wooden bench in a jail cell next to you.

>cast old man
You hold your hand out in a fist, then open it slowly. Your hand warms up as a dancing ball of flame forms above your palm. With a gentle flick of your wrist, the flames fly out of your hand and to the old man.

* * *

Airship Escape
An Interactive Fiction by Jenny Tran, Kenneth Cox
Release 1 / Serial number 130314 / Inform 7 build 6G60 (I6/v6.32 lib 6/12N) SD

Jail
The light above you is dim. Your jail cell is open. You can leave through the west doorway.

There is an old man sitting on a wooden bench in a jail cell next to you.

You see a torch that looks lightable. You recall a fire spell that you learned when you first became a wizard.

>light torch
(first taking the torch)

>x torch
You see nothing special about the torch.

>w
West Jail
You see that there are no guards around. Now to escape!

You can see a Jail Door and a pot (in which is a silver key) here.

* * *

Airship Escape
An Interactive Fiction by Jenny Tran, Kenneth Cox
Release 1 / Serial number 130314 / Inform 7 build 6G60 (I6/v6.32 lib 6/12N) SD

Jail
The light above you is dim. Your jail cell is open. You can leave through the west doorway.

There is an old man sitting on a wooden bench in a jail cell next to you.

You see a torch that looks lightable. You recall a fire spell that you learned when you first became a wizard.

>light old man
(first taking the old man)
I don't suppose the old man would care for that.

* * *

Airship Escape
An Interactive Fiction by Jenny Tran, Kenneth Cox
Release 1 / Serial number 130314 / Inform 7 build 6G60 (I6/v6.32 lib 6/12N) SD

Jail
The light above you is dim. Your jail cell is open. You can leave through the west doorway.

There is an old man sitting on a wooden bench in a jail cell next to you.

You see a torch that looks lightable. You recall a fire spell that you learned when you first became a wizard.

>take old man
I don't suppose the old man would care for that.

>light torch
(first taking the torch)

* * *

>w
West Jail
You see that there are no guards around. Now to escape!

You can see a Jail Door and a pot (in which is a silver key) here.

>take key
Taken.

>light key
You consider lighting the silver key but realize that it would be silly to do so.

>x key
You see nothing special about the silver key.

* * *

Airship Escape
An Interactive Fiction by Jenny Tran, Kenneth Cox
Release 1 / Serial number 130314 / Inform 7 build 6G60 (I6/v6.32 lib 6/12N) SD

Jail
The light above you is dim. Your jail cell is open. You can leave through the west doorway.

There is an old man sitting on a wooden bench in a jail cell next to you.

You see a torch that looks lightable. You recall a fire spell that you learned when you first became a wizard.

>cast fire on torch
You pick up the torch first.

You hold your hand out in a fist, then open it slowly. Your hand warms up as a dancing ball of flame forms above your palm. With a gentle flick of your wrist, the flames fly out of your hand and to the torch. Now it is on fire.

>x torch
You see nothing special about the torch.

>take torch
Taken.

* * *

>x torch
You see nothing special about the torch.

>w
Darkness
You walk into another part of the jail. It's pitch black. You're sure you can light it up with fire.

* * *

>cast fire on torch
You pick up the torch first.

You hold your hand out in a fist, then open it slowly. Your hand warms up as a dancing ball of flame forms above your palm. With a gentle flick of your wrist, the flames fly out of your hand and to the torch. Now it is on fire.

>w
West Jail
You see that there are no guards around. Now to escape!

You can see a Jail Door and a pot (closed) here.

>open pot
You open the pot, revealing a silver key.

>e
Jail
The light above you is dim. Your jail cell is open. You can leave through the west doorway.

There is an old man sitting on a wooden bench in a jail cell next to you.

>x torch
You see nothing special about the torch.

* * *

>open pot
You open the pot, revealing a silver key.

>take key
Taken.

>unlock door
What do you want to unlock the Jail Door with?

>key
The jail door opens. You can go north into the light.

>n
(first opening the Jail Door)

Hallway 1F
A hallway stretches out before you. The walls are plain, the lights are dim, and there are rooms all along the hallway. The jail rooms are in the south. A room labeled the "Exit Room" is to the north. You see a plain door leading to the lounge to the east.

You can enter the elevator here.

You can also see an Exit Room Door, a Lounge Door and a Jail Door here.

>e
(first opening the Lounge Door)

Lounge
It's a small area with two doors, one to the north and one to the east. There is a table in the middle of the room, on top of which lies a dirty tablecloth and an old photograph. There are wooden chairs scattered about the room and an uncomfortable-looking couch to the side.

You can see an East Servant Room Door, a North Servant Room Door, a Lounge Door and a photograph here.

>x photograph
It's a picture of the captain and a huge, golden key attached to his belt.

* * *

>w
West Jail
You see that there are no guards around. Now to escape!

You can see a Jail Door and a pot (closed) here.

>get
What do you want to get?

>pot
Taken.

>open pot
You open the pot, revealing a silver key.

* * *

>take key
Taken.

>inventory
You are carrying:
  a silver key
  a pot (open but empty)
  a torch (providing light)

>put torch in pot
You put the torch into the pot.

>e
Jail
The light above you is dim. Your jail cell is open. You can leave through the west doorway.

There is an old man sitting on a wooden bench in a jail cell next to you.

>w
West Jail
You see that there are no guards around. Now to escape!

You can see a Jail Door here.

>n
(first opening the Jail Door)
It seems to be locked.

>unlock door
What do you want to unlock the Jail Door with?

* * *

>enter elevator
Elevator
To operate: Press number.

>go into pot
That's not something you can enter.

>press 2
You press button 2. The elevator whirs into action and moves to the correct level.

* * *

>exit
East Hallway 2F
You can enter the elevator here.

>w
West Hallway 2F
You can see a Crew Quarters Door here.

>open crew quarters door
You open the Crew Quarters Door.

>enter crew quarters
Crew Quarters
You can see a Crew Quarters Door and a note here.

>read note
time whale